111111111111111111111111111111111111111111111111111111111111111
10000000100000C000110100000000110100100010C0100000000C000001001
1C0000000001010101010110100000000000000100100100001010000000001
10000110101110010100010000100101100101001001010100000100C000001
100001010010010000C00000000001100000000000000C00110101001000101
111001100000000100101010000000110000000001111000000000000001101
1000001001110000000000000000001111111100000000001100110010C0001
100001111111110001001111111111111111100011111111000010010011001
101100000110000000011000001111000000001100111111111111110001001
1P10100101C010100101110110011110000C0010000101010010100101010E1
111111111111111111111111111111111111111111111111111111111111111
