11111111
1P100C11
10000111
11110001
1C000111
11110001
1E0001C1
11111111
